###################################
#OOOOOOO#OOOOOOOOOOOOOOOOOOOOOOOOOO
OOOOOOOO##############OOOOOOOOOOOOO
#OOOOOOO#OOOOOOOOOOOOOOOOOOOOOOOOOO
##################O################
#OOOTOOO#OOOOOOOOOOOOOOOOOOOOOOOOOO
EOTOTOTX###########################
#TTOOOTT###########################
##########OOOOOOO#OOOOOOOO##OOOOOOO