###################################
#OOOOOOO#OOOOOOOOOOOOOOOOOOOOOOOOOO
EOOOOOOOO#############OOOOOOOOOOOOX
#OOOOOOO#OOOOOOOOOOOOOOOOOOOOOOOOOO
##################O################
#OOOOOOO#OOOOOOOOOOOOOOOOOOOOOOOOOO
OOOOOOOO###########################
#OOOOOOO###########################
##########OOOOOOO#OOOOOOOO##OOOOOOO