#########
EOOOOOOO#
#######O#
#XOOOOOO#
#########