####################################
#EOOOOOO#XOOOOOOOOOOOOOOOOOOOOOOOOO#
#######O##########################O#
#OOOOOOO##########################O#
#o################################O#
#OOOOOOOOOOOOOOOOOOOOOOOOOOOOOOOOOO#
####################################