###################################
#OOOOOOO#OOOOOOOOOOOOOOOOOOOOOOOOOO
OOOOOOOO##############OOOOOOOOOOOOO
#OOOOOOO#OOOOOOOOOOOOOOOOOOOOOOOOOO
##################O################
#OOOOOOO#OOOOOOOOOOOOOOOOOOOOOOOOOO
OOOOOOOO###########################
#OOOOOOO###########################
##########OOOOOOO#EOOOOOOX##OOOOOOO