###################################
#OOOOOOO#OOOOOOOOOOOOOOOOOOOOOOOOOO
OOOOOOOO##############OOOOOOOOOOOOO
#OOOOOOO#OOOOOOOOOOOOOOOOOOOOOOOOOO
##################O################
#OOOOOOO#OOOOOOOOOOOOOOOOOOOOOOOOOO
EOOOOOOX###########################
#OOOOOOO###########################
##########OOOOOOO#OOOOOOOO##OOOOOOO