###################################
#OOOOOOO#OOOOOOTOOOOOOOOOOOOOOOOOOO
EOOOOOOOO#############OOOOOOOOOOOTX
#OOOOOOO#OOOOOOOOOOOOOOOOTOOOOOOOOO
##################O################
#OOOOOOO#OOOOOOOOOOOOOOOOOOOOOOOOOO
OOOOOOOO###########################
#OOOOOOO###########################
##########OOOOOOO#OOOOOOOO##OOOOOOO