############
#E====TT####
#====T=TT###
#######=TT##
##=X=##T=T##
##===##TT=##
###=======##
############