#############################
#############X###############
#==2========================#
#===========================#
#============p==============#
#===========================#
#===========================#
#===========================#
#===========================#
#===========================#
#===========================#
#===========================#
#===========================#
#===========================#
#############E###############
#############################