###############
#E==========###
#============##
#######=b====##
##============#
#######===b==##
##============#
#######=====b##
##============#
##==c===#######
##============#
##========C===#
##===========X#
###############