#############################
#############X###############
#===========================#
#===========================#
#============o==============#
#===========================#
#===========================#
#===========================#
#===========================#
#===========================#
#===========================#
#===========================#
#===========================#
#===========================#
#############E###############
#############################