##########
#E#OOOOOO#
#O#O#O##T#
#OOO#OO#X#
#O####O#O#
#OOOOTOOO#
##########