###############
#E==========###
#============##
#######======##
##============#
#######======##
##============#
#######======##
##============#
##======#######
##============#
##========C===#
##===========X#
###############