############
#EOOOOTT####
#OOOOTOTT###
#######OTT##
##OXO##TOT##
##OOO##TTO##
###OOOOOOO##
############