####################################
#E#======###########################
#=#=#=##T##===######################
#===#==#==========================X#
#=####=#=###########################
#====T===###########################
#C===###############################
#====###############################
#====###############################
#====###############################
#====###############################
#====###############################
####################################