####################################
#========###########################
#========###########################
#==E==============================##
#========###################TTTT=###
#========###################=====###
############################=TTTT###
############################=====###
############################TTTT=###
############################=====###
###############################X####
####################################
