###############
#OOOOOOOOOOOOO#
#O#T#T#T#O#T#O#
#OOO#OOO#T#O#X#
#T#O#O#OOO#O###
#O#OOO#T#O#O###
#O#O#T#O#OOO###
#O#T#O#O#O#T###
#OOOOOOOOOOOO##
######E########
###############