####################################
#E#======###########################
#=#=#=##T##===######################
#===#==#==========================X#
#=####=#=###########################
#====T===###########################
####################################